The Beginning
bg3.png
5
32 36

11 20

1 1 1 1 1 1 1 1 1 1 1
 1 1 1 1 1 1 1 1 1 1
2 2 2 2 2 2 2 2 2 2 2
 2 2 2 2 2 2 2 2 2 2
3 3 3 3 3 3 3 3 3 3 3
 3 3 3 3 3 3 3 3 3 3
4 4 4 4 4 4 4 4 4 4 4
 4 4 4 4 4 4 4 4 4 4
4 4 4 4 4 4 4 4 4 4 4
 4 4 4 4 4 4 4 4 4 4
4 4 4 4 4 4 4 4 4 4 4
 4 4 4 4 4 4 4 4 4 4
8 8 8 8 8 8 8 8 8 8 8
 8 8 8 8 8 8 8 8 8 8
8 8 8 8 8 8 8 8 8 8 8
 8 8 8 8 8 8 8 8 8 8 
8 8 8 8 8 8 8 8 8 8 8
 8 8 8 8 8 8 8 8 8 8 
8 8 8 8 8 8 8 8 8 8 8
 8 8 8 8 8 8 8 8 8 8