Handle with care
bg1.png
2
32 36

11 20

 10 10 10 10 10 10 10 10 10 10 10
   10 10 10 10 10 10 10 10 10 10  
 8  8  8  8  8  8  8  8  8  8  8
   8  8  8  8  8  8  8  8  8  8
 8  8  8  8  8  8  8  8  8  8  8
   8  8  8  8  8  8  8  8  8  8
 8  8  8  8  8  8  8  8  8  8  8
   8  8  8  8  8  8  8  8  8  8
 8  8  8  8  8  8  8  8  8  8  8
   8  8  8  8  8  8  8  8  8  8
 8  8  8  8  8  8  8  8  8  8  8
   8  8  8  8  8  8  8  8  8  8
 8  8  8  8  8  8  8  8  8  8  8
   8  8  8  8  8  8  8  8  8  8
 8  8  8  8  8  8  8  8  8  8  8
   8  8  8  8  8  8  8  8  8  8
 8  8  8  8  8  8  8  8  8  8  8
   8  8  8  8  8  8  8  8  8  8
 8  8  8  8  8  8  8  8  8  8  8
   8  8  8  8  8  8  8  8  8  8
