The Beginning
bg3.png
5
32 36

11 20

0 0 0 0 0 0 0 0 0 0 0
 1 1 1 1 1 1 1 1 1 1
2 2 2 2 2 2 2 2 2 2 2
 3 3 3 3 3 3 3 3 3 3
4 4 4 4 4 4 4 4 4 4 4
 5 5 5 5 5 5 5 5 5 5
7 7 7 7 7 7 7 7 7 7 7
 8 8 8 8 8 8 8 8 8 8
8 8 8 8 8 8 8 8 8 8 8
 8 8 8 8 8 8 8 8 8 8
8 8 8 8 8 8 8 8 8 8 8
 8 8 8 8 8 8 8 8 8 8
8 8 8 8 8 8 8 8 8 8 8
 8 8 8 8 8 8 8 8 8 8
8 8 8 8 8 8 8 8 8 8 8
 8 8 8 8 8 8 8 8 8 8 
8 8 8 8 8 8 8 8 8 8 8
 8 8 8 8 8 8 8 8 8 8 
8 8 8 8 8 8 8 8 8 8 8
 8 8 8 8 8 8 8 8 8 8
