Fill the gaps
bg1.png
2
1
852398
32 36

11 20

 1  1  1  2  2  2  3  3  3  8  8
   8  2  2  2  1  1  1  3  3  3  
 10 10 10 10 10 10 8 10 10 10 10
   8  1  1  1  3  3  3  2  2  2
 3  3  3  2  2  2  1  1  1  8  8
   10 10 10 10 10 10 10 8 10 10
 8  8  8  8  8  8  8  8  8  8  8
   8  8  8  8  8  8  8  8  8  8
 8  8  8  8  8  8  8  8  8  8  8
   8  8  8  8  8  8  8  8  8  8
 8  8  8  8  8  8  8  8  8  8  8
   8  8  8  8  8  8  8  8  8  8
 8  8  8  8  8  8  8  8  8  8  8
   8  8  8  8  8  8  8  8  8  8
 8  8  8  8  8  8  8  8  8  8  8
   8  8  8  8  8  8  8  8  8  8
 8  8  8  8  8  8  8  8  8  8  8
   8  8  8  8  8  8  8  8  8  8
 8  8  8  8  8  8  8  8  8  8  8
   8  8  8  8  8  8  8  8  8  8
