Crates =/= Bubbles
bg1.png
2
32 36

11 20

1 1 1 2 2 2 3 3 3 4 4
 5 5 5 5 5 5 5 5 5 5 
8 8 8 8 8 8 8 8 8 8 8
 8 8 8 8 8 8 8 8 8 8
8 8 8 8 8 8 8 8 8 8 8
 8 8 8 8 8 8 8 8 8 8
8 8 8 8 8 8 8 8 8 8 8
 8 8 8 8 8 8 8 8 8 8
8 8 8 8 8 8 8 8 8 8 8
 8 8 8 8 8 8 8 8 8 8
8 8 8 8 8 8 8 8 8 8 8
 8 8 8 8 8 8 8 8 8 8
8 8 8 8 8 8 8 8 8 8 8
 8 8 8 8 8 8 8 8 8 8
8 8 8 8 8 8 8 8 8 8 8
 8 8 8 8 8 8 8 8 8 8
8 8 8 8 8 8 8 8 8 8 8
 8 8 8 8 8 8 8 8 8 8
8 8 8 8 8 8 8 8 8 8 8
 8 8 8 8 8 8 8 8 8 8
