The Beginning
bg2.png
2
32 36

11 20

1 1 1 1 1 1 1 1 1 1 1
 4 4 4 4 4 4 4 4 4 4
4 4 4 4 4 4 4 4 4 4 4
 3 3 3 3 3 3 3 3 3 3
3 3 3 3 3 3 3 3 3 3 3
 3 3 3 3 3 3 3 3 3 3
3 3 3 3 3 3 3 3 3 3 3
 3 3 3 3 3 3 3 3 3 3
4 4 4 4 4 4 4 4 4 4 4
 4 4 4 4 4 4 4 4 4 4
8 8 8 8 8 8 8 8 8 8 8
 8 8 8 8 8 8 8 8 8 8
8 8 8 8 8 8 8 8 8 8 8
 8 8 8 8 8 8 8 8 8 8
8 8 8 8 8 8 8 8 8 8 8
 8 8 8 8 8 8 8 8 8 8 
8 8 8 8 8 8 8 8 8 8 8
 8 8 8 8 8 8 8 8 8 8 
8 8 8 8 8 8 8 8 8 8 8
 8 8 8 8 8 8 8 8 8 8